#########################################
#                                       #
#                                       #
#                                       #
#      ^^^            ~~~~              #
#     ^^^^^               ~~~           #
#     ^^^^^                  ~~##########
#      ^^^                              *
#                                       #
#                           ~~ ##########
#                        ~~~~           #
#                        #~~            #
#                     ####         %    #
#~~~~                                   #
#~~~~~                                  #
#########################################