#########################################
#                                 ^^^^^^#
#                                 ^^^^^^#
#         ^^                      ^^^*^^#
#        ^^^^           P               #
#                      PPP              #
#                       P               #
*                                   %   #
#                                       #
#                 ~~~~~~            ^^^^#
#                 ~~~~~~             ^^^#
#                 ~~~~~~               ^#
#                                       #
#~~~                                    #
#~~~~~                                  #
#########################################